360,438,1206,2252,3896,06-11-2011,2011-4, Kanban
360,16,77,22,115,06-09-2010,2010-3, Kanban
360,0,13,0,13,24-09-2010,2010-3, Kanban
360,343,580,146,1069,30-08-2010,2010-3, Kanban
360,2,89,39,130,26-08-2010,2010-3, Kanban
360,0,181,11,192,25-08-2010,2010-3, Kanban
360,0,0,0,0,24-08-2010,2010-3, Kanban
360,0,16,10,26,23-08-2010,2010-3, Kanban
360,13,2,4,19,27-08-2010,2010-3, Kanban
360,0,17,23,40,31-08-2010,2010-3, Kanban
360,0,3,1,4,17-09-2010,2010-3, Kanban
360,2,41,16,59,03-11-2010,2010-4, Kanban
360,0,0,0,0,09-11-2010,2010-4, Kanban
360,0,0,1,1,06-12-2010,2010-4, Kanban
360,0,0,0,0,09-02-2011,2011-1, Kanban
360,0,0,0,0,08-02-2011,2011-1, Kanban
360,0,0,0,0,02-02-2011,2011-1, Kanban
360,0,0,0,0,04-02-2011,2011-1, Kanban
360,0,0,0,0,03-02-2011,2011-1, Kanban
360,0,0,0,0,07-02-2011,2011-1, Kanban
360,0,93,84,177,14-04-2011,2011-2, Kanban
360,5,82,12,99,19-04-2011,2011-2, Kanban
360,0,0,0,0,25-04-2011,2011-2, Kanban
360,2,123,23,148,15-04-2011,2011-2, Kanban
360,5,32,21,58,18-04-2011,2011-2, Kanban
360,4,223,37,264,26-04-2011,2011-2, Kanban
360,7,10,20,37,20-04-2011,2011-2, Kanban
360,0,0,0,0,01-04-2011,2011-2, Kanban
360,166,1048,390,1604,27-04-2011,2011-2, Kanban
360,0,0,0,0,25-03-2011,2011-1, Kanban
360,1,1,0,2,21-04-2011,2011-2, Kanban
360,15,94,30,139,05-04-2011,2011-2, Kanban
360,0,56,26,82,13-04-2011,2011-2, Kanban
360,0,0,0,0,04-04-2011,2011-2, Kanban
360,733,84,124,941,07-04-2011,2011-2, Kanban
360,71,332,130,533,28-04-2011,2011-2, Kanban
360,3,667,271,941,06-04-2011,2011-2, Kanban
360,15,87,37,139,12-04-2011,2011-2, Kanban
360,41,118,79,238,11-04-2011,2011-2, Kanban
360,60,264,88,412,29-04-2011,2011-2, Kanban
360,110,322,191,623,03-05-2011,2011-2, Kanban
360,24231,48,128,24407,02-05-2011,2011-2, Kanban
360,28,52,72,152,01-05-2011,2011-2, Kanban
360,141,394,218,753,04-05-2011,2011-2, Kanban
360,84,160,70,314,05-05-2011,2011-2, Kanban
360,29,13,13,55,06-05-2011,2011-2, Kanban
360,5,5,0,10,21-06-2011,2011-2, Kanban
360,0,0,0,0,30-05-2011,2011-2, Kanban
360,0,0,0,0,09-06-2011,2011-2, Kanban
360,0,0,0,0,14-06-2011,2011-2, Kanban
360,0,0,0,0,15-06-2011,2011-2, Kanban
360,0,0,0,0,26-09-2011,2011-3, Kanban
360,2,14,2,18,19-10-2011,2011-4, Kanban
360,0,0,0,0,16-06-2011,2011-2, Kanban
360,716,1355,2413,4484,05-11-2011,2011-4, Kanban
360,52,302,94,448,02-11-2011,2011-4, Kanban
360,0,0,2,2,17-08-2011,2011-3, Kanban
360,0,0,0,0,28-05-2012,2012-2, Kanban
360,65,0,0,65,20-10-2011,2011-4, Kanban
360,51,152,29,232,28-10-2011,2011-4, Kanban
360,16,69,45,130,21-10-2011,2011-4, Kanban
360,1,42,13,56,26-10-2011,2011-4, Kanban
360,39,103,6,148,27-10-2011,2011-4, Kanban
360,35,348,70,453,03-11-2011,2011-4, Kanban
360,14,41,7,62,31-10-2011,2011-4, Kanban
360,9,138,6,153,24-10-2011,2011-4, Kanban
360,0,0,0,0,18-10-2011,2011-4, Kanban
360,548,819,456,1823,04-11-2011,2011-4, Kanban
360,10,55,10,75,30-01-2012,2012-1, Kanban
360,19,1344,184,1547,17-01-2012,2012-1, Kanban
360,69,421,296,786,07-11-2011,2011-4, Kanban
360,305,159,155,619,25-10-2011,2011-4, Kanban
360,0,154,2,156,01-11-2011,2011-4, Kanban
360,0,49,7,56,29-10-2011,2011-4, Kanban
360,0,0,0,0,21-11-2011,2011-4, Kanban
360,1135,885,81138,83158,25-01-2012,2012-1, Kanban
360,67,71,6,144,08-11-2011,2011-4, Kanban
360,0,6,1,7,09-11-2011,2011-4, Kanban
360,2,34,91,127,14-11-2011,2011-4, Kanban
360,0,11,27,38,09-02-2012,2012-1, Kanban
360,0,0,0,0,05-05-2012,2012-2, Kanban
360,0,71,2,73,25-11-2011,2011-4, Kanban
360,0,0,0,0,07-12-2011,2011-4, Kanban
360,0,96,18,114,12-12-2011,2011-4, Kanban
360,83,233,143,459,23-01-2012,2012-1, Kanban
360,7,113,20,140,27-01-2012,2012-1, Kanban
360,391,600,185,1176,24-01-2012,2012-1, Kanban
360,180,528,165,873,31-01-2012,2012-1, Kanban
360,344,468,232,1044,18-01-2012,2012-1, Kanban
360,11,179,21,211,16-01-2012,2012-1, Kanban
360,4,37,50,91,01-02-2012,2012-1, Kanban
360,102,332,157,591,26-01-2012,2012-1, Kanban
360,24,277,57,358,19-01-2012,2012-1, Kanban
360,1,36,23,60,20-01-2012,2012-1, Kanban
360,67,144,132,343,02-02-2012,2012-1, Kanban
360,38,32,53,123,03-02-2012,2012-1, Kanban
360,0,0,0,0,15-02-2012,2012-1, Kanban
360,0,0,3,3,06-02-2012,2012-1, Kanban
360,4,29,36,69,29-05-2012,2012-2, Kanban
360,0,0,0,0,28-03-2012,2012-1, Kanban
360,0,0,0,0,07-05-2012,2012-2, Kanban
360,0,0,0,0,13-06-2012,2012-2, Kanban
360,0,0,0,0,05-07-2012,2012-3, Kanban
360,57,244,114,415,20-06-2012,2012-2, Kanban
360,42,55,59,156,15-06-2012,2012-2, Kanban
360,9,267,22,298,16-06-2012,2012-2, Kanban
360,293,893,266,1452,19-06-2012,2012-2, Kanban
360,1,104,45,150,27-06-2012,2012-2, Kanban
360,25,92,52,169,26-06-2012,2012-2, Kanban
360,3,99,14,116,23-06-2012,2012-2, Kanban
360,1467,307,108,1882,18-06-2012,2012-2, Kanban
360,339,3599,89167,93105,21-06-2012,2012-2, Kanban
360,313,3537,380,4230,28-06-2012,2012-2, Kanban
360,131,347,104,582,29-06-2012,2012-2, Kanban
360,116,410,208,734,22-06-2012,2012-2, Kanban
360,40,257,92,389,25-06-2012,2012-2, Kanban
360,0,18,0,18,11-06-2012,2012-2, Kanban
360,897,2184,434,3515,12-06-2012,2012-2, Kanban
360,0,1,7,8,02-07-2012,2012-3, Kanban
360,70,277,93,440,30-06-2012,2012-2, Kanban
360,0,0,0,0,01-07-2012,2012-3, Kanban
360,2,96,18,116,03-07-2012,2012-3, Kanban
360,52,72,2,126,04-07-2012,2012-3, Kanban
360,0,0,0,0,15-09-2012,2012-3, Kanban
360,0,0,0,0,05-09-2012,2012-3, Kanban
360,0,0,0,0,07-08-2012,2012-3, Kanban
360,0,0,0,0,22-08-2012,2012-3, Kanban
360,0,0,0,0,06-08-2012,2012-3, Kanban
360,0,0,0,0,08-08-2012,2012-3, Kanban
360,0,0,0,0,01-09-2012,2012-3, Kanban
360,0,0,0,0,10-08-2012,2012-3, Kanban
360,0,0,0,0,25-08-2012,2012-3, Kanban
360,0,0,0,0,14-08-2012,2012-3, Kanban
360,0,0,0,0,18-09-2012,2012-3, Kanban
360,0,0,0,0,31-08-2012,2012-3, Kanban
360,0,0,0,0,26-09-2012,2012-3, Kanban
360,0,0,0,0,28-08-2012,2012-3, Kanban
360,0,0,0,0,23-08-2012,2012-3, Kanban
360,0,0,0,0,27-09-2012,2012-3, Kanban
360,0,0,0,0,06-09-2012,2012-3, Kanban
360,0,6,0,6,29-09-2012,2012-3, Kanban
360,69,23,91,183,12-12-2012,2012-4, Kanban
360,47,77,49,173,20-12-2012,2012-4, Kanban
360,0,0,0,0,24-08-2012,2012-3, Kanban
360,0,0,0,0,30-08-2012,2012-3, Kanban
360,0,3,0,3,07-09-2012,2012-3, Kanban
360,0,36,1,37,13-09-2012,2012-3, Kanban
360,0,0,0,0,19-09-2012,2012-3, Kanban
360,0,0,42,42,12-10-2012,2012-4, Kanban
360,218,47,64,329,18-12-2012,2012-4, Kanban
360,21,138,69,228,17-12-2012,2012-4, Kanban
360,6,16,12,34,19-12-2012,2012-4, Kanban
360,0,12,0,12,20-11-2012,2012-4, Kanban
360,258,1272,50,1580,14-12-2012,2012-4, Kanban
360,9,43,10,62,29-11-2012,2012-4, Kanban
360,11,28,13,52,13-12-2012,2012-4, Kanban
360,0,0,0,0,15-12-2012,2012-4, Kanban
360,187,3718,370,4275,21-12-2012,2012-4, Kanban
360,0,0,0,0,22-12-2012,2012-4, Kanban
360,0,0,146,146,29-12-2012,2012-4, Kanban
360,4,1,6,11,24-12-2012,2012-4, Kanban
360,0,0,0,0,26-12-2012,2012-4, Kanban
360,0,0,0,0,27-12-2012,2012-4, Kanban
Neon,68,301,100,469,25-07-2012,2012-3, Kanban
Neon,172,679,580,1431,30-05-2011,2011-2, Kanban
Neon,20,21,35,76,30-11-2010,2010-4, Kanban
Neon,26,163,167,356,06-09-2010,2010-3, Kanban
Neon,14,508,17,539,18-10-2010,2010-4, Kanban
Neon,9,9247,128,9384,16-02-2011,2011-1, Kanban
Neon,953,761,142,1856,09-11-2010,2010-4, Kanban
Neon,0,157,11,168,21-02-2011,2011-1, Kanban
Neon,68,82,58,208,14-10-2010,2010-4, Kanban
Neon,21,72,26,119,09-02-2011,2011-1, Kanban
Neon,0,0,0,0,29-10-2010,2010-4, Kanban
Neon,0,0,0,0,27-09-2010,2010-3, Kanban
Neon,1328,3874,1301,6503,15-03-2011,2011-1, Kanban
Neon,2886,128,23001,26015,15-09-2010,2010-3, Kanban
Neon,2,30,12,44,28-09-2010,2010-3, Kanban
Neon,3,30,212,245,19-07-2011,2011-3, Kanban
Neon,23,302,67,392,01-10-2010,2010-4, Kanban
Neon,3,13,0,16,06-02-2012,2012-1, Kanban
Neon,13,94,38,145,08-10-2010,2010-4, Kanban
Neon,22,118,21,161,22-10-2010,2010-4, Kanban
Neon,944,2102,735,3781,21-09-2010,2010-3, Kanban
Neon,0,201,71,272,22-09-2010,2010-3, Kanban
Neon,24,309,19,352,09-09-2010,2010-3, Kanban
Neon,4,49,32,85,16-09-2010,2010-3, Kanban
Neon,1539,492,76,2107,12-10-2010,2010-4, Kanban
Neon,79,253,44,376,11-11-2010,2010-4, Kanban
Neon,1,47,0,48,17-09-2010,2010-3, Kanban
Neon,52,514,70,636,20-09-2010,2010-3, Kanban
Neon,29,265,48,342,16-12-2010,2010-4, Kanban
Neon,1,1,1,3,07-09-2010,2010-3, Kanban
Neon,0,10,0,10,14-09-2010,2010-3, Kanban
Neon,0,0,0,0,26-10-2010,2010-4, Kanban
Neon,0,193,0,193,18-09-2010,2010-3, Kanban
Neon,11,118,16,145,24-05-2011,2011-2, Kanban
Neon,1591,353,578,2522,23-09-2010,2010-3, Kanban
Neon,14,187,89,290,17-02-2011,2011-1, Kanban
Neon,195,536,149,880,02-11-2010,2010-4, Kanban
Neon,103,123,175,401,08-07-2011,2011-3, Kanban
Neon,1,8,4,13,07-10-2010,2010-4, Kanban
Neon,0,4,4,8,29-09-2010,2010-3, Kanban
Neon,0,9,0,9,11-10-2010,2010-4, Kanban
Neon,17,118,30,165,30-09-2010,2010-3, Kanban
Neon,3,95,43,141,06-10-2010,2010-4, Kanban
Neon,0,13,0,13,05-10-2010,2010-4, Kanban
Neon,1,37,7,45,13-10-2010,2010-4, Kanban
Neon,4,7,8,19,04-10-2010,2010-4, Kanban
Neon,39,165,16,220,20-10-2010,2010-4, Kanban
Neon,19,49,15,83,02-08-2011,2011-3, Kanban
Neon,10,71,8,89,27-10-2010,2010-4, Kanban
Neon,2,29,3,34,10-10-2010,2010-4, Kanban
Neon,0,45,10,55,15-10-2010,2010-4, Kanban
Neon,0,5,1,6,21-01-2011,2011-1, Kanban
Neon,10,1370,145,1525,16-10-2010,2010-4, Kanban
Neon,0,178,4,182,25-10-2010,2010-4, Kanban
Neon,77,9481,217,9775,06-01-2011,2011-1, Kanban
Neon,0,0,0,0,19-10-2010,2010-4, Kanban
Neon,114,545,100,759,23-12-2010,2010-4, Kanban
Neon,0,43,26,69,17-12-2010,2010-4, Kanban
Neon,7,185,22,214,12-01-2011,2011-1, Kanban
Neon,0,0,0,0,20-12-2010,2010-4, Kanban
Neon,58,141,112,311,21-10-2010,2010-4, Kanban
Neon,142,268,137,547,24-11-2010,2010-4, Kanban
Neon,294,688,209,1191,05-01-2011,2011-1, Kanban
Neon,131,365,34,530,07-01-2011,2011-1, Kanban
Neon,22,133,14,169,03-11-2010,2010-4, Kanban
Neon,5,25,8,38,28-10-2010,2010-4, Kanban
Neon,180,468,189,837,03-03-2011,2011-1, Kanban
Neon,0,3,1,4,25-11-2010,2010-4, Kanban
Neon,41,2,11,54,06-07-2011,2011-3, Kanban
Neon,25,68,23,116,04-11-2010,2010-4, Kanban
Neon,309,550,193,1052,08-11-2010,2010-4, Kanban
Neon,0,99,26,125,03-01-2011,2011-1, Kanban
Neon,0,1,1,2,10-11-2010,2010-4, Kanban
Neon,0,0,0,0,12-11-2010,2010-4, Kanban
Neon,0,2,6,8,23-11-2010,2010-4, Kanban
Neon,975,1103,237,2315,16-11-2010,2010-4, Kanban
Neon,2,43,108,153,28-12-2010,2010-4, Kanban
Neon,0,2,1,3,10-02-2011,2011-1, Kanban
Neon,8,26,7,41,04-01-2011,2011-1, Kanban
Neon,0,163,26,189,28-02-2012,2012-1, Kanban
Neon,0,52,26,78,17-11-2010,2010-4, Kanban
Neon,0,28,0,28,21-11-2010,2010-4, Kanban
Neon,0,94,0,94,20-11-2010,2010-4, Kanban
Neon,81,113,38,232,18-11-2010,2010-4, Kanban
Neon,10,75,37,122,18-01-2011,2011-1, Kanban
Neon,0,2,8,10,22-11-2010,2010-4, Kanban
Neon,0,72,0,72,10-01-2011,2011-1, Kanban
Neon,346,336,68,750,11-01-2011,2011-1, Kanban
Neon,74,288,24,386,26-11-2010,2010-4, Kanban
Neon,107,25110,119,25336,01-09-2011,2011-3, Kanban
Neon,179,1412,346,1937,24-01-2011,2011-1, Kanban
Neon,2,107,14,123,02-12-2010,2010-4, Kanban
Neon,1,0,0,1,02-09-2011,2011-3, Kanban
Neon,0,0,0,0,23-09-2011,2011-3, Kanban
Neon,2,90,13,105,11-02-2011,2011-1, Kanban
Neon,3,130,36,169,15-02-2011,2011-1, Kanban
Neon,2,34,11,47,08-12-2010,2010-4, Kanban
Neon,17,9385,189,9591,24-02-2011,2011-1, Kanban
Neon,0,67,11,78,09-12-2010,2010-4, Kanban
Neon,7,55,10,72,23-02-2011,2011-1, Kanban
Neon,0,0,0,0,15-12-2010,2010-4, Kanban
Neon,0,18,1,19,10-12-2010,2010-4, Kanban
Neon,0,0,0,0,04-07-2011,2011-3, Kanban
Neon,41,123,30,194,13-12-2010,2010-4, Kanban
Neon,0,15,1,16,27-12-2010,2010-4, Kanban
Neon,1,11,25,37,01-02-2011,2011-1, Kanban
Neon,9,224,31,264,22-02-2011,2011-1, Kanban
Neon,10,87,17,114,17-01-2011,2011-1, Kanban
Neon,116,186,105,407,14-01-2011,2011-1, Kanban
Neon,0,173,17,190,20-01-2011,2011-1, Kanban
Neon,347,944,206,1497,31-01-2011,2011-1, Kanban
Neon,1463,1411,352,3226,26-01-2011,2011-1, Kanban
Neon,38,8,267,313,11-05-2011,2011-2, Kanban
Neon,0,36,0,36,19-01-2011,2011-1, Kanban
Neon,0,8,0,8,28-01-2011,2011-1, Kanban
Neon,8,11,10,29,30-01-2011,2011-1, Kanban
Neon,0,3500,21,3521,07-02-2011,2011-1, Kanban
Neon,0,1,0,1,08-02-2011,2011-1, Kanban
Neon,0,0,37,37,02-02-2011,2011-1, Kanban
Neon,287,640,262,1189,11-03-2011,2011-1, Kanban
Neon,0,16,0,16,03-02-2011,2011-1, Kanban
Neon,2,198,23,223,14-02-2011,2011-1, Kanban
Neon,87,383,32,502,01-03-2011,2011-1, Kanban
Neon,0,62,23,85,02-06-2011,2011-2, Kanban
Neon,97,702,88,887,11-10-2011,2011-4, Kanban
Neon,35,143,15,193,16-08-2011,2011-3, Kanban
Neon,2,15,35,52,29-03-2011,2011-1, Kanban
Neon,4,229,25,258,16-03-2011,2011-1, Kanban
Neon,13,18,11,42,25-05-2011,2011-2, Kanban
Neon,116,780,92,988,10-03-2011,2011-1, Kanban
Neon,0,0,3,3,18-02-2011,2011-1, Kanban
Neon,630,2506,404,3540,07-03-2011,2011-1, Kanban
Neon,0,94,32,126,16-05-2011,2011-2, Kanban
Neon,0,0,0,0,08-03-2011,2011-1, Kanban
Neon,0,0,1,1,09-03-2011,2011-1, Kanban
Neon,0,0,1,1,25-02-2011,2011-1, Kanban
Neon,20,115,29,164,28-02-2011,2011-1, Kanban
Neon,0,66,60,126,03-06-2011,2011-2, Kanban
Neon,0,4,0,4,02-03-2011,2011-1, Kanban
Neon,293,150,70,513,24-06-2011,2011-2, Kanban
Neon,0,4,1,5,23-05-2011,2011-2, Kanban
Neon,32,254,35,321,31-03-2011,2011-1, Kanban
Neon,16,4,5,25,13-05-2011,2011-2, Kanban
Neon,30,53,14,97,10-05-2011,2011-2, Kanban
Neon,0,130,18,148,14-03-2011,2011-1, Kanban
Neon,10,65,5,80,11-07-2011,2011-3, Kanban
Neon,2,1,5,8,17-03-2011,2011-1, Kanban
Neon,58,193,91,342,21-03-2011,2011-1, Kanban
Neon,8,62,29,99,30-03-2011,2011-1, Kanban
Neon,1,5,9,15,28-03-2011,2011-1, Kanban
Neon,658,596,195,1449,31-08-2011,2011-3, Kanban
Neon,40,52,13,105,22-03-2011,2011-1, Kanban
Neon,0,20,4,24,24-03-2011,2011-1, Kanban
Neon,2,126,29,157,01-04-2011,2011-2, Kanban
Neon,0,0,0,0,06-04-2011,2011-2, Kanban
Neon,371,206,132,709,18-05-2011,2011-2, Kanban
Neon,0,0,1,1,05-07-2011,2011-3, Kanban
Neon,80,263,46,389,22-09-2011,2011-3, Kanban
Neon,10,129,13,152,08-04-2011,2011-2, Kanban
Neon,0,0,0,0,07-04-2011,2011-2, Kanban
Neon,365,205,95,665,03-08-2011,2011-3, Kanban
Neon,94,341,85,520,23-06-2011,2011-2, Kanban
Neon,3,43,4,50,26-05-2011,2011-2, Kanban
Neon,88,131,64,283,08-06-2011,2011-2, Kanban
Neon,25,126,9,160,09-05-2011,2011-2, Kanban
Neon,32,75,30,137,27-05-2011,2011-2, Kanban
Neon,0,0,3,3,12-05-2011,2011-2, Kanban
Neon,0,0,0,0,17-05-2011,2011-2, Kanban
Neon,0,17,14,31,20-05-2011,2011-2, Kanban
Neon,13,0,8,21,19-05-2011,2011-2, Kanban
Neon,2,74,10,86,21-09-2011,2011-3, Kanban
Neon,76,52,29,157,07-06-2011,2011-2, Kanban
Neon,0,0,0,0,06-06-2011,2011-2, Kanban
Neon,59,227,65,351,31-05-2011,2011-2, Kanban
Neon,13,24,25,62,17-06-2011,2011-2, Kanban
Neon,105,242,197,544,29-06-2011,2011-2, Kanban
Neon,0,3,2,5,01-06-2011,2011-2, Kanban
Neon,0,28,21,49,23-02-2012,2012-1, Kanban
Neon,33,13,11,57,21-06-2011,2011-2, Kanban
Neon,0,6,0,6,15-08-2011,2011-3, Kanban
Neon,0,0,2,2,09-06-2011,2011-2, Kanban
Neon,0,240,15,255,06-09-2011,2011-3, Kanban
Neon,0,2,2,4,14-06-2011,2011-2, Kanban
Neon,24,433,86,543,19-04-2012,2012-2, Kanban
Neon,245,698,295,1238,20-09-2011,2011-3, Kanban
Neon,0,3,26,29,16-06-2011,2011-2, Kanban
Neon,0,2,1,3,15-06-2011,2011-2, Kanban
Neon,34,175,66,275,20-06-2011,2011-2, Kanban
Neon,153,397,72,622,01-07-2011,2011-3, Kanban
Neon,0,13,6,19,30-06-2011,2011-2, Kanban
Neon,216,887,286,1389,19-09-2011,2011-3, Kanban
Neon,0,0,2,2,22-06-2011,2011-2, Kanban
Neon,10,41,48,99,28-06-2011,2011-2, Kanban
Neon,143,300,55,498,27-06-2011,2011-2, Kanban
Neon,0,57,6,63,06-09-2012,2012-3, Kanban
Neon,104,479,157,740,09-08-2011,2011-3, Kanban
Neon,26,1347,22,1395,07-07-2011,2011-3, Kanban
Neon,4,11,23,38,12-07-2011,2011-3, Kanban
Neon,10,388,21,419,13-07-2011,2011-3, Kanban
Neon,469,1210,461,2140,15-07-2011,2011-3, Kanban
Neon,588,476,367,1431,08-08-2011,2011-3, Kanban
Neon,0,0,0,0,20-07-2011,2011-3, Kanban
Neon,0,4,6,10,05-09-2011,2011-3, Kanban
Neon,12,798,131,941,25-07-2011,2011-3, Kanban
Neon,176,488,168,832,22-08-2011,2011-3, Kanban
Neon,1,20,1,22,14-07-2011,2011-3, Kanban
Neon,3,8,12,23,16-09-2011,2011-3, Kanban
Neon,125,578,127,830,14-09-2011,2011-3, Kanban
Neon,126,685,122,933,18-07-2011,2011-3, Kanban
Neon,83,602,105,790,26-07-2011,2011-3, Kanban
Neon,25,69,29,123,29-08-2011,2011-3, Kanban
Neon,5,141,20,166,28-07-2011,2011-3, Kanban
Neon,3,21,15,39,26-08-2011,2011-3, Kanban
Neon,0,0,0,0,27-07-2011,2011-3, Kanban
Neon,2,50,2,54,04-08-2011,2011-3, Kanban
Neon,0,2,0,2,05-08-2011,2011-3, Kanban
Neon,19,27,12,58,17-08-2011,2011-3, Kanban
Neon,0,4,0,4,02-10-2011,2011-4, Kanban
Neon,169,15,40,224,17-10-2011,2011-4, Kanban
Neon,0,107,21,128,21-02-2012,2012-1, Kanban
Neon,0,7,3,10,23-08-2011,2011-3, Kanban
Neon,65,163,9,237,13-10-2011,2011-4, Kanban
Neon,0,5,2,7,25-08-2011,2011-3, Kanban
Neon,0,13,4,17,30-08-2011,2011-3, Kanban
Neon,0,0,0,0,10-03-2012,2012-1, Kanban
Neon,0,68,6,74,09-03-2012,2012-1, Kanban
Neon,3,28,2,33,04-11-2011,2011-4, Kanban
Neon,0,233,4,237,17-02-2012,2012-1, Kanban
Neon,107,365,119,591,20-11-2012,2012-4, Kanban
Neon,51,204,51,306,23-07-2012,2012-3, Kanban
Neon,0,8,3,11,12-09-2011,2011-3, Kanban
Neon,0,19,12,31,13-09-2011,2011-3, Kanban
Neon,36,1,15,52,27-09-2011,2011-3, Kanban
Neon,0,12,2,14,27-10-2011,2011-4, Kanban
Neon,0,31,3,34,04-10-2011,2011-4, Kanban
Neon,53,58,30,141,29-11-2011,2011-4, Kanban
Neon,0,5,7,12,03-10-2011,2011-4, Kanban
Neon,20,96,17,133,02-01-2012,2012-1, Kanban
Neon,0,0,0,0,21-12-2011,2011-4, Kanban
Neon,5,139,17,161,25-10-2011,2011-4, Kanban
Neon,0,12,0,12,14-10-2011,2011-4, Kanban
Neon,0,124,5,129,26-10-2011,2011-4, Kanban
Neon,0,0,1,1,26-09-2011,2011-3, Kanban
Neon,1,10,46,57,28-09-2011,2011-3, Kanban
Neon,0,10,6,16,30-09-2011,2011-3, Kanban
Neon,100,118,41,259,06-03-2012,2012-1, Kanban
Neon,19,31,30,80,29-09-2011,2011-3, Kanban
Neon,44,149,79,272,16-01-2012,2012-1, Kanban
Neon,0,41,8,49,05-10-2011,2011-4, Kanban
Neon,0,14,3,17,14-11-2011,2011-4, Kanban
Neon,6,55,57,118,19-10-2011,2011-4, Kanban
Neon,47,19,9,75,07-10-2011,2011-4, Kanban
Neon,0,42,5,47,10-10-2011,2011-4, Kanban
Neon,0,1,2,3,24-02-2012,2012-1, Kanban
Neon,54,80,60,194,15-10-2011,2011-4, Kanban
Neon,142,53,44,239,18-10-2011,2011-4, Kanban
Neon,0,3,1,4,09-11-2011,2011-4, Kanban
Neon,124,471,138,733,22-03-2012,2012-1, Kanban
Neon,0,4,2,6,31-10-2011,2011-4, Kanban
Neon,54,0,0,54,21-10-2011,2011-4, Kanban
Neon,29,0,6,35,23-10-2011,2011-4, Kanban
Neon,16,16,0,32,24-10-2011,2011-4, Kanban
Neon,119,273,68,460,08-02-2012,2012-1, Kanban
Neon,210,197,30,437,10-11-2011,2011-4, Kanban
Neon,0,77,8,85,08-11-2011,2011-4, Kanban
Neon,21,112,64,197,13-12-2011,2011-4, Kanban
Neon,134,263,42,439,08-12-2011,2011-4, Kanban
Neon,2,0,1,3,27-02-2012,2012-1, Kanban
Neon,11,182,93,286,14-02-2012,2012-1, Kanban
Neon,6,2,0,8,02-12-2011,2011-4, Kanban
Neon,20,25,8,53,25-11-2011,2011-4, Kanban
Neon,0,0,2,2,02-11-2011,2011-4, Kanban
Neon,53,38,29,120,21-11-2011,2011-4, Kanban
Neon,101,165,20,286,12-12-2011,2011-4, Kanban
Neon,34,12,39,85,11-11-2011,2011-4, Kanban
Neon,1,95,178,274,17-11-2011,2011-4, Kanban
Neon,4,45,9,58,16-11-2011,2011-4, Kanban
Neon,22,770,19,811,06-12-2011,2011-4, Kanban
Neon,0,1,43,44,15-11-2011,2011-4, Kanban
Neon,8,47,8,63,28-11-2011,2011-4, Kanban
Neon,2,57,29,88,07-03-2012,2012-1, Kanban
Neon,0,0,0,0,18-11-2011,2011-4, Kanban
Neon,53,38,29,120,24-11-2011,2011-4, Kanban
Neon,16,211,52,279,29-02-2012,2012-1, Kanban
Neon,54,120,19,193,23-11-2011,2011-4, Kanban
Neon,21,31,8,60,18-02-2012,2012-1, Kanban
Neon,0,8,1,9,19-12-2011,2011-4, Kanban
Neon,0,596,29,625,04-01-2012,2012-1, Kanban
Neon,64,1914,361,2339,07-12-2011,2011-4, Kanban
Neon,1,3,12,16,03-10-2012,2012-4, Kanban
Neon,4,0,1,5,05-12-2011,2011-4, Kanban
Neon,88,108,53,249,09-12-2011,2011-4, Kanban
Neon,0,0,0,0,31-01-2012,2012-1, Kanban
Neon,1,71,0,72,18-01-2012,2012-1, Kanban
Neon,37,118,101,256,12-06-2012,2012-2, Kanban
Neon,0,8,2,10,17-01-2012,2012-1, Kanban
Neon,16,36,13,65,20-02-2012,2012-1, Kanban
Neon,154,53,29,236,25-02-2012,2012-1, Kanban
Neon,262,956,221,1439,22-12-2011,2011-4, Kanban
Neon,172,266,85,523,20-12-2011,2011-4, Kanban
Neon,0,137,4,141,15-12-2011,2011-4, Kanban
Neon,1627,612,181,2420,26-12-2011,2011-4, Kanban
Neon,128,316,92,536,09-02-2012,2012-1, Kanban
Neon,0,64,27,91,16-02-2012,2012-1, Kanban
Neon,8,57,28,93,23-04-2012,2012-2, Kanban
Neon,1,55,9,65,27-07-2012,2012-3, Kanban
Neon,0,34,7,41,21-03-2012,2012-1, Kanban
Neon,0,329,2,331,28-12-2011,2011-4, Kanban
Neon,48,143,60,251,10-01-2012,2012-1, Kanban
Neon,109,316,156,581,12-01-2012,2012-1, Kanban
Neon,0,3,0,3,08-03-2012,2012-1, Kanban
Neon,0,45,0,45,03-01-2012,2012-1, Kanban
Neon,69,268,209,546,07-02-2012,2012-1, Kanban
Neon,7,169,14,190,09-01-2012,2012-1, Kanban
Neon,58,343,128,529,06-01-2012,2012-1, Kanban
Neon,1,2,12,15,11-01-2012,2012-1, Kanban
Neon,0,56,12,68,13-01-2012,2012-1, Kanban
Neon,0,9,3,12,19-01-2012,2012-1, Kanban
Neon,165,45,53,263,23-01-2012,2012-1, Kanban
Neon,2,0,4,6,25-01-2012,2012-1, Kanban
Neon,163,1530,295,1988,03-05-2012,2012-2, Kanban
Neon,0,0,0,0,27-01-2012,2012-1, Kanban
Neon,10,38,4,52,24-04-2012,2012-2, Kanban
Neon,3,28,7,38,30-01-2012,2012-1, Kanban
Neon,0,0,0,0,10-04-2012,2012-2, Kanban
Neon,50,41,27,118,11-02-2012,2012-1, Kanban
Neon,0,0,0,0,18-04-2012,2012-2, Kanban
Neon,31,173,65,269,04-06-2012,2012-2, Kanban
Neon,93,126,53,272,10-02-2012,2012-1, Kanban
Neon,11,257,202,470,15-02-2012,2012-1, Kanban
Neon,0,104,43,147,08-05-2012,2012-2, Kanban
Neon,0,25,0,25,04-05-2012,2012-2, Kanban
Neon,0,9,10,19,26-05-2012,2012-2, Kanban
Neon,0,0,0,0,24-03-2012,2012-1, Kanban
Neon,88,832,65,985,23-03-2012,2012-1, Kanban
Neon,0,1,1,2,01-03-2012,2012-1, Kanban
Neon,1,157,19,177,02-03-2012,2012-1, Kanban
Neon,0,15,5,20,03-03-2012,2012-1, Kanban
Neon,41,71,19,131,27-03-2012,2012-1, Kanban
Neon,92,215,50,357,20-03-2012,2012-1, Kanban
Neon,0,130,4,134,30-03-2012,2012-1, Kanban
Neon,174,620,147,941,12-03-2012,2012-1, Kanban
Neon,103,313,184,600,13-03-2012,2012-1, Kanban
Neon,1,32,1,34,12-05-2012,2012-2, Kanban
Neon,20,103,72,195,25-05-2012,2012-2, Kanban
Neon,0,0,1,1,09-04-2012,2012-2, Kanban
Neon,0,9,8,17,15-03-2012,2012-1, Kanban
Neon,237,201,101,539,28-03-2012,2012-1, Kanban
Neon,4,9,4,17,16-03-2012,2012-1, Kanban
Neon,8,45,8,61,11-05-2012,2012-2, Kanban
Neon,603,2323,426,3352,15-05-2012,2012-2, Kanban
Neon,1,65,13,79,28-05-2012,2012-2, Kanban
Neon,472,708,134,1314,17-04-2012,2012-2, Kanban
Neon,4,216,29,249,26-03-2012,2012-1, Kanban
Neon,0,54,41,95,05-04-2012,2012-2, Kanban
Neon,0,17,5,22,29-03-2012,2012-1, Kanban
Neon,0,130,2,132,04-04-2012,2012-2, Kanban
Neon,0,191,26,217,02-04-2012,2012-2, Kanban
Neon,92,336,156,584,03-04-2012,2012-2, Kanban
Neon,134,545,173,852,29-08-2012,2012-3, Kanban
Neon,13,0,1,14,06-08-2012,2012-3, Kanban
Neon,0,277,4,281,13-04-2012,2012-2, Kanban
Neon,0,425,32,457,16-04-2012,2012-2, Kanban
Neon,43,446,73,562,20-07-2012,2012-3, Kanban
Neon,344,263,54,661,10-05-2012,2012-2, Kanban
Neon,8,124,59,191,25-04-2012,2012-2, Kanban
Neon,0,0,0,0,26-04-2012,2012-2, Kanban
Neon,30,35,25,90,05-06-2012,2012-2, Kanban
Neon,204,517,124,845,30-04-2012,2012-2, Kanban
Neon,12,151,62,225,02-05-2012,2012-2, Kanban
Neon,0,0,0,0,30-05-2012,2012-2, Kanban
Neon,5,205,27,237,09-05-2012,2012-2, Kanban
Neon,0,8,1,9,03-08-2012,2012-3, Kanban
Neon,17,60,40,117,14-05-2012,2012-2, Kanban
Neon,726,3993,392,5111,12-10-2012,2012-4, Kanban
Neon,31,71,12,114,16-05-2012,2012-2, Kanban
Neon,1,0,2,3,17-05-2012,2012-2, Kanban
Neon,171,381,129,681,18-05-2012,2012-2, Kanban
Neon,265,1581,269,2115,23-05-2012,2012-2, Kanban
Neon,387,1242,150,1779,07-06-2012,2012-2, Kanban
Neon,45,550,71,666,09-06-2012,2012-2, Kanban
Neon,7,7,1,15,21-05-2012,2012-2, Kanban
Neon,40,269,87,396,12-07-2012,2012-3, Kanban
Neon,0,0,2,2,24-05-2012,2012-2, Kanban
Neon,5,412,121,538,29-05-2012,2012-2, Kanban
Neon,69,356,128,553,24-07-2012,2012-3, Kanban
Neon,114,90,30,234,02-06-2012,2012-2, Kanban
Neon,0,30,4,34,01-06-2012,2012-2, Kanban
Neon,145,104,16,265,08-06-2012,2012-2, Kanban
Neon,237,83,60,380,06-06-2012,2012-2, Kanban
Neon,44,526,54,624,10-06-2012,2012-2, Kanban
Neon,39,364,136,539,11-06-2012,2012-2, Kanban
Neon,2,80,23,105,13-06-2012,2012-2, Kanban
Neon,0,0,6,6,14-06-2012,2012-2, Kanban
Neon,0,34,1,35,15-06-2012,2012-2, Kanban
Neon,10,214,72,296,09-07-2012,2012-3, Kanban
Neon,1,94,15,110,25-06-2012,2012-2, Kanban
Neon,351,141,127,619,13-07-2012,2012-3, Kanban
Neon,0,0,1,1,10-07-2012,2012-3, Kanban
Neon,0,0,0,0,06-07-2012,2012-3, Kanban
Neon,0,1,9,10,23-08-2012,2012-3, Kanban
Neon,8,20,33,61,21-07-2012,2012-3, Kanban
Neon,0,17,63,80,14-07-2012,2012-3, Kanban
Neon,35,515,70,620,19-07-2012,2012-3, Kanban
Neon,234,7,3,244,18-07-2012,2012-3, Kanban
Neon,0,4,10,14,16-07-2012,2012-3, Kanban
Neon,58,773,111,942,17-07-2012,2012-3, Kanban
Neon,0,0,0,0,28-07-2012,2012-3, Kanban
Neon,11,274,21,306,26-07-2012,2012-3, Kanban
Neon,10,193,23,226,30-07-2012,2012-3, Kanban
Neon,0,0,0,0,31-07-2012,2012-3, Kanban
Neon,0,0,0,0,02-08-2012,2012-3, Kanban
Neon,0,202,29,231,28-08-2012,2012-3, Kanban
Neon,0,51,18,69,07-08-2012,2012-3, Kanban
Neon,0,0,0,0,08-08-2012,2012-3, Kanban
Neon,4049,1084,572,5705,18-08-2012,2012-3, Kanban
Neon,3927,932,572,5431,10-08-2012,2012-3, Kanban
Neon,6,99,47,152,16-08-2012,2012-3, Kanban
Neon,52,60,26,138,09-08-2012,2012-3, Kanban
Neon,0,90,1,91,14-08-2012,2012-3, Kanban
Neon,0,1,2,3,05-09-2012,2012-3, Kanban
Neon,0,21,2,23,17-08-2012,2012-3, Kanban
Neon,0,0,1,1,08-09-2012,2012-3, Kanban
Neon,199,552,150,901,22-08-2012,2012-3, Kanban
Neon,0,80,8,88,19-08-2012,2012-3, Kanban
Neon,0,40,4,44,20-08-2012,2012-3, Kanban
Neon,26,194,115,335,21-08-2012,2012-3, Kanban
Neon,62,1,1,64,27-09-2012,2012-3, Kanban
Neon,0,10,1,11,25-08-2012,2012-3, Kanban
Neon,5,109,34,148,27-08-2012,2012-3, Kanban
Neon,257,16,55,328,24-08-2012,2012-3, Kanban
Neon,15,12,6,33,14-09-2012,2012-3, Kanban
Neon,75,20,28,123,25-09-2012,2012-3, Kanban
Neon,41,107,14,162,07-09-2012,2012-3, Kanban
Neon,0,667,4,671,13-09-2012,2012-3, Kanban
Neon,128,142,98,368,30-08-2012,2012-3, Kanban
Neon,16,132,10,158,11-09-2012,2012-3, Kanban
Neon,0,6,10,16,31-08-2012,2012-3, Kanban
Neon,0,158,7,165,04-09-2012,2012-3, Kanban
Neon,0,0,1,1,03-09-2012,2012-3, Kanban
Neon,121,602,25,748,10-09-2012,2012-3, Kanban
Neon,53,538,34,625,12-09-2012,2012-3, Kanban
Neon,92,590,56,738,23-10-2012,2012-4, Kanban
Neon,180,888,200,1268,17-09-2012,2012-3, Kanban
Neon,77,586,102,765,15-09-2012,2012-3, Kanban
Neon,26,23,4,53,21-09-2012,2012-3, Kanban
Neon,0,12,4,16,16-09-2012,2012-3, Kanban
Neon,77,573,115,765,18-09-2012,2012-3, Kanban
Neon,2,0,0,2,19-09-2012,2012-3, Kanban
Neon,0,27,1,28,11-10-2012,2012-4, Kanban
Neon,5,423,5,433,24-09-2012,2012-3, Kanban
Neon,2,40,11,53,26-09-2012,2012-3, Kanban
Neon,1,177,8,186,29-09-2012,2012-3, Kanban
Neon,27,198,16,241,28-09-2012,2012-3, Kanban
Neon,62,1,1,64,04-10-2012,2012-4, Kanban
Neon,46,416,78,540,05-10-2012,2012-4, Kanban
Neon,0,0,0,0,06-10-2012,2012-4, Kanban
Neon,0,36,9,45,01-10-2012,2012-4, Kanban
Neon,0,0,0,0,15-10-2012,2012-4, Kanban
Neon,40,664,53,757,25-10-2012,2012-4, Kanban
Neon,207,848,338,1393,16-10-2012,2012-4, Kanban
Neon,0,29,3,32,17-10-2012,2012-4, Kanban
Neon,16,166,22,204,18-10-2012,2012-4, Kanban
Neon,309,392,385,1086,19-10-2012,2012-4, Kanban
Neon,776,919,212,1907,30-10-2012,2012-4, Kanban
Neon,0,0,16,16,22-10-2012,2012-4, Kanban
Neon,10,12,0,22,03-01-2013,2013-1, Kanban
Neon,42,144,65,251,26-10-2012,2012-4, Kanban
Neon,380,515,78,973,27-10-2012,2012-4, Kanban
Neon,0,1,3,4,28-10-2012,2012-4, Kanban
Neon,285,614,254,1153,06-11-2012,2012-4, Kanban
Neon,968,2984,377,4329,29-10-2012,2012-4, Kanban
Neon,77,342,88,507,04-12-2012,2012-4, Kanban
Neon,4,381,3,388,03-12-2012,2012-4, Kanban
Neon,19,188,27,234,26-11-2012,2012-4, Kanban
Neon,88,565,18,671,01-11-2012,2012-4, Kanban
Neon,100,164,35,299,31-10-2012,2012-4, Kanban
Neon,1580,4186,32,5798,07-11-2012,2012-4, Kanban
Neon,507,1034,519,2060,21-11-2012,2012-4, Kanban
Neon,34,28935,447,29416,08-11-2012,2012-4, Kanban
Neon,70,421,35,526,14-11-2012,2012-4, Kanban
Neon,0,25,3,28,09-11-2012,2012-4, Kanban
Neon,0,384,0,384,12-11-2012,2012-4, Kanban
Neon,1,19092,2845,21938,13-11-2012,2012-4, Kanban
Neon,48,2694,2943,5685,15-11-2012,2012-4, Kanban
Neon,0,16,17,33,16-11-2012,2012-4, Kanban
Neon,0,0,3,3,17-11-2012,2012-4, Kanban
Neon,3,312,39,354,19-11-2012,2012-4, Kanban
Neon,963,482,82,1527,22-11-2012,2012-4, Kanban
Neon,146,153,8,307,29-11-2012,2012-4, Kanban
Neon,49,600,49,698,24-11-2012,2012-4, Kanban
Neon,0,23,3,26,23-11-2012,2012-4, Kanban
Neon,9,109,19,137,27-11-2012,2012-4, Kanban
Neon,30,12056,0,12086,30-11-2012,2012-4, Kanban
Neon,1,81,6,88,28-11-2012,2012-4, Kanban
Neon,307,481,87,875,01-12-2012,2012-4, Kanban
Neon,0,0,0,0,09-01-2013,2013-1, Kanban
Neon,853,331,166,1350,05-12-2012,2012-4, Kanban
Neon,803,499,159,1461,07-12-2012,2012-4, Kanban
Neon,270,589,232,1091,06-12-2012,2012-4, Kanban
Neon,20,491,19,530,11-12-2012,2012-4, Kanban
Neon,28050,1574,62,29686,10-12-2012,2012-4, Kanban
Neon,313,82,43,438,08-12-2012,2012-4, Kanban
Neon,0,140,23,163,02-01-2013,2013-1, Kanban
Neon,123,0,20,143,11-01-2013,2013-1, Kanban
Frontend,435,517,266,1218,20-09-2010,2010-3, Kanban
Frontend,41,154,55,250,16-09-2010,2010-3, Kanban
Frontend,94,49,56,199,21-09-2010,2010-3, Kanban
Frontend,462,374,258,1094,08-10-2010,2010-4, Kanban
Frontend,27,132,117,276,15-09-2010,2010-3, Kanban
Frontend,121,194,80,395,22-09-2010,2010-3, Kanban
Frontend,76,515,167,758,23-09-2010,2010-3, Kanban
Frontend,6,236,24,266,13-04-2011,2011-2, Kanban
Frontend,53,558,139,750,14-10-2010,2010-4, Kanban
Frontend,17,69,61,147,15-10-2010,2010-4, Kanban
Frontend,297,295,199,791,02-12-2011,2011-4, Kanban
Frontend,0,0,0,0,07-09-2010,2010-3, Kanban
Frontend,0,48,70,118,08-09-2010,2010-3, Kanban
Frontend,38,269,213,520,28-09-2010,2010-3, Kanban
Frontend,3,193,30,226,07-10-2010,2010-4, Kanban
Frontend,63,310,337,710,01-10-2010,2010-4, Kanban
Frontend,130,174,54,358,10-09-2010,2010-3, Kanban
Frontend,23,46,10,79,13-09-2010,2010-3, Kanban
Frontend,63,291,124,478,17-09-2010,2010-3, Kanban
Frontend,0,0,5,5,29-09-2010,2010-3, Kanban
Frontend,12,96,33,141,24-09-2010,2010-3, Kanban
Frontend,0,0,3,3,27-09-2010,2010-3, Kanban
Frontend,76,527,167,770,30-09-2010,2010-3, Kanban
Frontend,0,0,0,0,17-01-2011,2011-1, Kanban
Frontend,2,53,27,82,06-10-2010,2010-4, Kanban
Frontend,13,423,63,499,04-10-2010,2010-4, Kanban
Frontend,39,283,133,455,18-10-2010,2010-4, Kanban
Frontend,2,42,12,56,05-10-2010,2010-4, Kanban
Frontend,86,511,81,678,28-10-2010,2010-4, Kanban
Frontend,0,24,16,40,12-10-2010,2010-4, Kanban
Frontend,2,51,43,96,11-10-2010,2010-4, Kanban
Frontend,153,268,120,541,13-10-2010,2010-4, Kanban
Frontend,3,264,34,301,19-10-2010,2010-4, Kanban
Frontend,0,6,0,6,11-11-2010,2010-4, Kanban
Frontend,0,1,2,3,15-11-2010,2010-4, Kanban
Frontend,4,82,51,137,21-10-2010,2010-4, Kanban
Frontend,167,161,63,391,20-10-2010,2010-4, Kanban
Frontend,13,188,15,216,12-11-2010,2010-4, Kanban
Frontend,47,33,65,145,30-11-2010,2010-4, Kanban
Frontend,1,8,4,13,25-10-2010,2010-4, Kanban
Frontend,21,144,91,256,27-10-2010,2010-4, Kanban
Frontend,42,46,37,125,01-11-2010,2010-4, Kanban
Frontend,0,9,3,12,22-10-2010,2010-4, Kanban
Frontend,0,92,34,126,26-10-2010,2010-4, Kanban
Frontend,0,21,2,23,08-12-2010,2010-4, Kanban
Frontend,0,0,0,0,29-10-2010,2010-4, Kanban
Frontend,307,805,984,2096,08-11-2010,2010-4, Kanban
Frontend,22,239,109,370,04-11-2010,2010-4, Kanban
Frontend,0,30,4,34,02-11-2010,2010-4, Kanban
Frontend,0,0,0,0,22-11-2010,2010-4, Kanban
Frontend,0,3,15,18,03-11-2010,2010-4, Kanban
Frontend,41,709,33,783,10-11-2010,2010-4, Kanban
Frontend,0,20,5,25,09-11-2010,2010-4, Kanban
Frontend,0,1,3,4,23-11-2010,2010-4, Kanban
Frontend,0,3,3,6,17-11-2010,2010-4, Kanban
Frontend,0,19,7,26,07-12-2010,2010-4, Kanban
Frontend,101,121,50,272,19-11-2010,2010-4, Kanban
Frontend,72,1499,619,2190,16-11-2010,2010-4, Kanban
Frontend,0,46,10,56,06-01-2011,2011-1, Kanban
Frontend,72,14,36,122,22-12-2010,2010-4, Kanban
Frontend,218,104,160,482,02-12-2010,2010-4, Kanban
Frontend,721,509,287,1517,16-12-2010,2010-4, Kanban
Frontend,36,30,56,122,09-12-2010,2010-4, Kanban
Frontend,0,0,0,0,18-11-2010,2010-4, Kanban
Frontend,49,656,138,843,06-04-2011,2011-2, Kanban
Frontend,18,50,63,131,25-11-2010,2010-4, Kanban
Frontend,92,54,8,154,06-12-2010,2010-4, Kanban
Frontend,82,122,346,550,24-11-2010,2010-4, Kanban
Frontend,1189,2137,1139,4465,10-01-2011,2011-1, Kanban
Frontend,9,15,8,32,01-12-2010,2010-4, Kanban
Frontend,0,52,3,55,03-12-2010,2010-4, Kanban
Frontend,298,226,571,1095,10-12-2010,2010-4, Kanban
Frontend,4,14,3,21,13-12-2010,2010-4, Kanban
Frontend,0,0,0,0,14-12-2010,2010-4, Kanban
Frontend,0,258,7,265,21-12-2010,2010-4, Kanban
Frontend,18,304,69,391,12-07-2011,2011-3, Kanban
Frontend,34,84,31,149,31-05-2011,2011-2, Kanban
Frontend,0,0,0,0,07-07-2011,2011-3, Kanban
Frontend,1,516,21,538,29-12-2010,2010-4, Kanban
Frontend,11,207,35,253,17-10-2012,2012-4, Kanban
Frontend,0,33,9,42,03-01-2011,2011-1, Kanban
Frontend,0,0,0,0,05-01-2011,2011-1, Kanban
Frontend,0,10,4,14,04-01-2011,2011-1, Kanban
Frontend,22,43,44,109,11-01-2011,2011-1, Kanban
Frontend,3,63,28,94,27-05-2011,2011-2, Kanban
Frontend,0,0,0,0,12-01-2011,2011-1, Kanban
Frontend,0,0,0,0,14-01-2011,2011-1, Kanban
Frontend,7,18,21,46,18-01-2011,2011-1, Kanban
Frontend,0,12,3,15,21-01-2011,2011-1, Kanban
Frontend,0,18,7,25,24-01-2011,2011-1, Kanban
Frontend,712,500,373,1585,31-01-2011,2011-1, Kanban
Frontend,0,0,0,0,03-02-2011,2011-1, Kanban
Frontend,36,5,33,74,08-02-2011,2011-1, Kanban
Frontend,0,20,49,69,01-02-2011,2011-1, Kanban
Frontend,43,212,65,320,14-02-2011,2011-1, Kanban
Frontend,1301,1291,845,3437,15-02-2011,2011-1, Kanban
Frontend,108,191,124,423,19-04-2011,2011-2, Kanban
Frontend,57,7,4,68,23-03-2011,2011-1, Kanban
Frontend,0,0,3,3,05-11-2011,2011-4, Kanban
Frontend,13,51,22,86,26-05-2011,2011-2, Kanban
Frontend,49,179,24,252,07-02-2011,2011-1, Kanban
Frontend,754,1269,579,2602,11-02-2011,2011-1, Kanban
Frontend,0,0,4,4,10-05-2011,2011-2, Kanban
Frontend,12,50,23,85,09-02-2011,2011-1, Kanban
Frontend,7028,7188,21777,35993,03-03-2011,2011-1, Kanban
Frontend,23,41,17,81,30-04-2011,2011-2, Kanban
Frontend,5,56,62,123,21-02-2011,2011-1, Kanban
Frontend,206,270,44,520,16-02-2011,2011-1, Kanban
Frontend,0,119,15,134,17-02-2011,2011-1, Kanban
Frontend,202,357,178,737,28-02-2011,2011-1, Kanban
Frontend,0,40,10,50,18-02-2011,2011-1, Kanban
Frontend,2,75,29,106,10-03-2011,2011-1, Kanban
Frontend,30,83,128,241,22-02-2011,2011-1, Kanban
Frontend,51,128,28,207,23-02-2011,2011-1, Kanban
Frontend,190,616,226,1032,24-02-2011,2011-1, Kanban
Frontend,449,966,474,1889,07-03-2011,2011-1, Kanban
Frontend,125,163,138,426,04-03-2011,2011-1, Kanban
Frontend,37,96,38,171,08-03-2011,2011-1, Kanban
Frontend,12,9,8,29,09-03-2011,2011-1, Kanban
Frontend,0,0,0,0,28-03-2011,2011-1, Kanban
Frontend,43,133,62,238,09-05-2011,2011-2, Kanban
Frontend,16,265,111,392,18-10-2011,2011-4, Kanban
Frontend,3,35,5,43,17-08-2011,2011-3, Kanban
Frontend,252,223,145,620,11-03-2011,2011-1, Kanban
Frontend,197,119,115,431,17-03-2011,2011-1, Kanban
Frontend,1,28,12,41,02-05-2011,2011-2, Kanban
Frontend,0,0,0,0,18-03-2011,2011-1, Kanban
Frontend,2,4,7,13,20-03-2011,2011-1, Kanban
Frontend,29,125,63,217,10-03-2012,2012-1, Kanban
Frontend,18,75,30,123,21-03-2012,2012-1, Kanban
Frontend,1,51,20,72,27-04-2011,2011-2, Kanban
Frontend,39,54,5,98,31-03-2011,2011-1, Kanban
Frontend,0,0,0,0,05-04-2011,2011-2, Kanban
Frontend,7025,7149,21782,35956,08-04-2011,2011-2, Kanban
Frontend,14,9,12,35,26-04-2011,2011-2, Kanban
Frontend,56,59,62,177,05-05-2011,2011-2, Kanban
Frontend,119,299,172,590,04-05-2011,2011-2, Kanban
Frontend,79,110,231,420,03-05-2011,2011-2, Kanban
Frontend,0,43,3,46,23-05-2011,2011-2, Kanban
Frontend,284,733,415,1432,14-07-2011,2011-3, Kanban
Frontend,98,935,127,1160,06-06-2011,2011-2, Kanban
Frontend,40,113,81,234,10-06-2011,2011-2, Kanban
Frontend,64,807,310,1181,01-06-2011,2011-2, Kanban
Frontend,76,154,71,301,13-05-2011,2011-2, Kanban
Frontend,23,26,21,70,16-05-2011,2011-2, Kanban
Frontend,163,163,108,434,19-05-2011,2011-2, Kanban
Frontend,0,0,1,1,07-06-2011,2011-2, Kanban
Frontend,0,7,10,17,20-05-2011,2011-2, Kanban
Frontend,5,33,24,62,25-05-2011,2011-2, Kanban
Frontend,149,980,172,1301,15-06-2011,2011-2, Kanban
Frontend,43,53,15,111,24-05-2011,2011-2, Kanban
Frontend,2,65,6,73,27-11-2012,2012-4, Kanban
Frontend,11,50,14,75,30-05-2011,2011-2, Kanban
Frontend,43,239,104,386,16-06-2011,2011-2, Kanban
Frontend,32,175,54,261,08-06-2011,2011-2, Kanban
Frontend,0,0,0,0,06-07-2011,2011-3, Kanban
Frontend,10,110,55,175,09-06-2011,2011-2, Kanban
Frontend,0,0,0,0,14-06-2011,2011-2, Kanban
Frontend,1,24,6,31,11-06-2011,2011-2, Kanban
Frontend,0,45,7,52,13-06-2011,2011-2, Kanban
Frontend,0,202,19,221,29-07-2011,2011-3, Kanban
Frontend,1,37,30,68,27-07-2011,2011-3, Kanban
Frontend,29,89,70,188,20-06-2011,2011-2, Kanban
Frontend,41,209,59,309,30-06-2011,2011-2, Kanban
Frontend,24,53,51,128,17-06-2011,2011-2, Kanban
Frontend,59,68,71,198,22-06-2011,2011-2, Kanban
Frontend,1274,387,299,1960,23-06-2011,2011-2, Kanban
Frontend,98,1304,264,1666,27-06-2011,2011-2, Kanban
Frontend,0,78,0,78,24-06-2011,2011-2, Kanban
Frontend,650,659,337,1646,01-07-2011,2011-3, Kanban
Frontend,327,1466,5423,7216,28-06-2011,2011-2, Kanban
Frontend,44,24,10,78,29-06-2011,2011-2, Kanban
Frontend,112,713,5222,6047,22-07-2011,2011-3, Kanban
Frontend,1910,3108,2495,7513,12-09-2011,2011-3, Kanban
Frontend,27,200,180,407,16-08-2011,2011-3, Kanban
Frontend,0,0,0,0,25-07-2011,2011-3, Kanban
Frontend,7,9,17,33,13-07-2011,2011-3, Kanban
Frontend,0,0,0,0,21-07-2011,2011-3, Kanban
Frontend,0,0,0,0,12-08-2011,2011-3, Kanban
Frontend,143,488,164,795,01-08-2011,2011-3, Kanban
Frontend,0,0,0,0,02-08-2011,2011-3, Kanban
Frontend,3,44,43,90,09-08-2011,2011-3, Kanban
Frontend,14,89,198,301,08-08-2011,2011-3, Kanban
Frontend,107,419,61,587,20-07-2011,2011-3, Kanban
Frontend,0,0,0,0,15-07-2011,2011-3, Kanban
Frontend,4,861,52,917,02-09-2011,2011-3, Kanban
Frontend,40,86,23,149,18-07-2011,2011-3, Kanban
Frontend,98,186,92,376,28-07-2011,2011-3, Kanban
Frontend,18,101,45,164,26-07-2011,2011-3, Kanban
Frontend,0,21,5,26,05-08-2011,2011-3, Kanban
Frontend,79,699,222,1000,04-08-2011,2011-3, Kanban
Frontend,204,1414,3831,5449,20-09-2011,2011-3, Kanban
Frontend,0,0,0,0,23-08-2011,2011-3, Kanban
Frontend,15,172,76,263,05-09-2011,2011-3, Kanban
Frontend,18,403,30,451,09-09-2011,2011-3, Kanban
Frontend,418,1622,1264,3304,23-01-2012,2012-1, Kanban
Frontend,32,137,37,206,08-09-2011,2011-3, Kanban
Frontend,5,41,25,71,26-08-2011,2011-3, Kanban
Frontend,0,46,11,57,07-10-2011,2011-4, Kanban
Frontend,0,0,2,2,29-08-2011,2011-3, Kanban
Frontend,88,359,106,553,15-09-2011,2011-3, Kanban
Frontend,280,472,152,904,06-09-2011,2011-3, Kanban
Frontend,2,20,20,42,30-08-2011,2011-3, Kanban
Frontend,0,23,2,25,31-08-2011,2011-3, Kanban
Frontend,9,369,127,505,11-10-2011,2011-4, Kanban
Frontend,155,389,185,729,07-09-2011,2011-3, Kanban
Frontend,12,40,24,76,21-09-2011,2011-3, Kanban
Frontend,40,136,53,229,13-09-2011,2011-3, Kanban
Frontend,29,58,15,102,14-09-2011,2011-3, Kanban
Frontend,9,104,26,139,30-09-2011,2011-3, Kanban
Frontend,0,7,5,12,19-09-2011,2011-3, Kanban
Frontend,0,27,19,46,04-10-2011,2011-4, Kanban
Frontend,52,134,35,221,16-09-2011,2011-3, Kanban
Frontend,0,1,2,3,12-10-2011,2011-4, Kanban
Frontend,201,782,287,1270,22-09-2011,2011-3, Kanban
Frontend,0,1,7,8,23-09-2011,2011-3, Kanban
Frontend,25,78,53,156,26-09-2011,2011-3, Kanban
Frontend,10,74,55,139,28-09-2011,2011-3, Kanban
Frontend,31,94,57,182,27-09-2011,2011-3, Kanban
Frontend,0,20,6,26,03-10-2011,2011-4, Kanban
Frontend,0,45,5,50,05-10-2011,2011-4, Kanban
Frontend,0,39,2,41,10-10-2011,2011-4, Kanban
Frontend,0,0,0,0,06-10-2011,2011-4, Kanban
Frontend,4,53,59,116,13-10-2011,2011-4, Kanban
Frontend,6,10,11,27,08-11-2011,2011-4, Kanban
Frontend,0,27,11,38,14-10-2011,2011-4, Kanban
Frontend,173,248,231,652,17-10-2011,2011-4, Kanban
Frontend,0,0,0,0,24-10-2011,2011-4, Kanban
Frontend,2,30,36,68,21-10-2011,2011-4, Kanban
Frontend,11,209,61,281,07-11-2011,2011-4, Kanban
Frontend,20,27,8,55,20-10-2011,2011-4, Kanban
Frontend,13,31,14,58,03-11-2011,2011-4, Kanban
Frontend,2,6,6,14,04-11-2011,2011-4, Kanban
Frontend,2,1,9,12,02-11-2011,2011-4, Kanban
Frontend,221,555,170,946,01-03-2012,2012-1, Kanban
Frontend,134,613,5024,5771,19-10-2011,2011-4, Kanban
Frontend,7,118,23,148,31-10-2011,2011-4, Kanban
Frontend,0,0,2,2,25-10-2011,2011-4, Kanban
Frontend,7,2,1,10,01-11-2011,2011-4, Kanban
Frontend,95,340,240,675,10-11-2011,2011-4, Kanban
Frontend,211,635,610,1456,24-01-2012,2012-1, Kanban
Frontend,0,4,5,9,14-11-2011,2011-4, Kanban
Frontend,0,44,0,44,16-11-2011,2011-4, Kanban
Frontend,0,92,34,126,15-11-2011,2011-4, Kanban
Frontend,1,35,11,47,24-11-2011,2011-4, Kanban
Frontend,0,16,3,19,23-11-2011,2011-4, Kanban
Frontend,0,52,2,54,17-11-2011,2011-4, Kanban
Frontend,750,446,86,1282,19-09-2012,2012-3, Kanban
Frontend,0,0,0,0,21-11-2011,2011-4, Kanban
Frontend,13,127,34,174,04-01-2012,2012-1, Kanban
Frontend,331,154,43,528,28-11-2011,2011-4, Kanban
Frontend,57,223,74,354,07-12-2011,2011-4, Kanban
Frontend,5,13,5,23,08-12-2011,2011-4, Kanban
Frontend,390,99,64,553,25-11-2011,2011-4, Kanban
Frontend,76,64,33,173,22-12-2011,2011-4, Kanban
Frontend,1,190,44,235,21-12-2011,2011-4, Kanban
Frontend,33,42,22,97,28-12-2011,2011-4, Kanban
Frontend,487,292,217,996,01-12-2011,2011-4, Kanban
Frontend,38,408,76,522,10-01-2012,2012-1, Kanban
Frontend,230,214,121,565,29-11-2011,2011-4, Kanban
Frontend,0,6,18,24,13-12-2011,2011-4, Kanban
Frontend,0,0,0,0,14-12-2011,2011-4, Kanban
Frontend,25,181,34,240,27-01-2012,2012-1, Kanban
Frontend,0,0,0,0,06-12-2011,2011-4, Kanban
Frontend,0,0,2,2,09-12-2011,2011-4, Kanban
Frontend,0,7,12,19,05-12-2011,2011-4, Kanban
Frontend,94,439,116,649,18-02-2012,2012-1, Kanban
Frontend,152,623,227,1002,17-01-2012,2012-1, Kanban
Frontend,176,311,157,644,02-02-2012,2012-1, Kanban
Frontend,553,973,380,1906,31-08-2012,2012-3, Kanban
Frontend,0,0,1,1,19-12-2011,2011-4, Kanban
Frontend,0,10,7,17,20-12-2011,2011-4, Kanban
Frontend,0,0,0,0,19-05-2012,2012-2, Kanban
Frontend,89,218,106,413,20-10-2012,2012-4, Kanban
Frontend,33,943,45,1021,09-05-2012,2012-2, Kanban
Frontend,0,0,0,0,12-01-2012,2012-1, Kanban
Frontend,182,375,305,862,16-01-2012,2012-1, Kanban
Frontend,0,6,1,7,19-01-2012,2012-1, Kanban
Frontend,21,68,66,155,25-01-2012,2012-1, Kanban
Frontend,0,0,0,0,20-01-2012,2012-1, Kanban
Frontend,0,0,0,0,30-01-2012,2012-1, Kanban
Frontend,0,0,0,0,03-02-2012,2012-1, Kanban
Frontend,5,63,25,93,04-02-2012,2012-1, Kanban
Frontend,42,92,138,272,18-01-2012,2012-1, Kanban
Frontend,0,70,8,78,26-01-2012,2012-1, Kanban
Frontend,162,762,158,1082,24-02-2012,2012-1, Kanban
Frontend,0,56,27,83,10-02-2012,2012-1, Kanban
Frontend,0,0,0,0,08-02-2012,2012-1, Kanban
Frontend,0,0,0,0,31-01-2012,2012-1, Kanban
Frontend,2,87,12,101,01-02-2012,2012-1, Kanban
Frontend,0,51,12,63,29-02-2012,2012-1, Kanban
Frontend,5,9,13,27,06-02-2012,2012-1, Kanban
Frontend,0,0,0,0,07-02-2012,2012-1, Kanban
Frontend,3,199,19,221,08-03-2012,2012-1, Kanban
Frontend,0,0,0,0,07-04-2012,2012-2, Kanban
Frontend,291,915,223,1429,11-04-2012,2012-2, Kanban
Frontend,39,81,37,157,11-02-2012,2012-1, Kanban
Frontend,0,0,0,0,15-02-2012,2012-1, Kanban
Frontend,0,0,0,0,22-02-2012,2012-1, Kanban
Frontend,118,179,101,398,07-03-2012,2012-1, Kanban
Frontend,0,0,2,2,23-02-2012,2012-1, Kanban
Frontend,0,10,0,10,02-03-2012,2012-1, Kanban
Frontend,9,22,12,43,03-03-2012,2012-1, Kanban
Frontend,23,85,64,172,06-03-2012,2012-1, Kanban
Frontend,1,186,14,201,12-03-2012,2012-1, Kanban
Frontend,2,1,10,13,13-06-2012,2012-2, Kanban
Frontend,15,178,60,253,26-06-2012,2012-2, Kanban
Frontend,0,22,21,43,19-06-2012,2012-2, Kanban
Frontend,69,173,41,283,13-03-2012,2012-1, Kanban
Frontend,19,49,27,95,05-03-2012,2012-1, Kanban
Frontend,8,27,18,53,05-05-2012,2012-2, Kanban
Frontend,43,103,28,174,31-03-2012,2012-1, Kanban
Frontend,0,0,0,0,13-04-2012,2012-2, Kanban
Frontend,27,166,80,273,09-03-2012,2012-1, Kanban
Frontend,0,0,4,4,22-03-2012,2012-1, Kanban
Frontend,0,0,0,0,12-05-2012,2012-2, Kanban
Frontend,166,361,147,674,14-03-2012,2012-1, Kanban
Frontend,98,405,94,597,24-03-2012,2012-1, Kanban
Frontend,961,1870,808,3639,21-06-2012,2012-2, Kanban
Frontend,6,100,15,121,17-03-2012,2012-1, Kanban
Frontend,0,40,3,43,16-03-2012,2012-1, Kanban
Frontend,1783,4181,1860,7824,14-04-2012,2012-2, Kanban
Frontend,0,0,0,0,28-06-2012,2012-2, Kanban
Frontend,0,1,17,18,12-04-2012,2012-2, Kanban
Frontend,13520,8344,5849,27713,20-06-2012,2012-2, Kanban
Frontend,11,442,63,516,17-04-2012,2012-2, Kanban
Frontend,3,88,15,106,27-03-2012,2012-1, Kanban
Frontend,20,72,20,112,29-03-2012,2012-1, Kanban
Frontend,0,1,1,2,27-04-2012,2012-2, Kanban
Frontend,11,130,25,166,25-04-2012,2012-2, Kanban
Frontend,0,0,0,0,10-04-2012,2012-2, Kanban
Frontend,11,442,63,516,16-04-2012,2012-2, Kanban
Frontend,11,442,63,516,26-04-2012,2012-2, Kanban
Frontend,64,66,39,169,10-05-2012,2012-2, Kanban
Frontend,3,62,3,68,29-06-2012,2012-2, Kanban
Frontend,0,0,0,0,29-11-2012,2012-4, Kanban
Frontend,1,1,0,2,19-04-2012,2012-2, Kanban
Frontend,7,227,7,241,24-04-2012,2012-2, Kanban
Frontend,3344,3261,4607,11212,04-05-2012,2012-2, Kanban
Frontend,0,18,4,22,07-05-2012,2012-2, Kanban
Frontend,0,32,11,43,08-05-2012,2012-2, Kanban
Frontend,0,9,0,9,05-07-2012,2012-3, Kanban
Frontend,2,37,48,87,26-05-2012,2012-2, Kanban
Frontend,16,138,24,178,22-05-2012,2012-2, Kanban
Frontend,0,24,21,45,15-05-2012,2012-2, Kanban
Frontend,19,27,12,58,23-05-2012,2012-2, Kanban
Frontend,4,195,21,220,16-05-2012,2012-2, Kanban
Frontend,0,0,1,1,01-06-2012,2012-2, Kanban
Frontend,0,74,14,88,24-05-2012,2012-2, Kanban
Frontend,0,176,45,221,18-07-2012,2012-3, Kanban
Frontend,19,387,63,469,07-06-2012,2012-2, Kanban
Frontend,0,0,0,0,26-07-2012,2012-3, Kanban
Frontend,4694,5535,8905,19134,08-08-2012,2012-3, Kanban
Frontend,10,22,29,61,20-08-2012,2012-3, Kanban
Frontend,4,97,24,125,12-06-2012,2012-2, Kanban
Frontend,0,45,2,47,27-09-2012,2012-3, Kanban
Frontend,0,7,0,7,14-06-2012,2012-2, Kanban
Frontend,43,103,28,174,01-08-2012,2012-3, Kanban
Frontend,16,45,55,116,18-06-2012,2012-2, Kanban
Frontend,48,75,53,176,22-09-2012,2012-3, Kanban
Frontend,0,0,0,0,16-06-2012,2012-2, Kanban
Frontend,0,0,1,1,30-06-2012,2012-2, Kanban
Frontend,56,306,74,436,16-10-2012,2012-4, Kanban
Frontend,0,0,0,0,10-07-2012,2012-3, Kanban
Frontend,0,0,0,0,23-06-2012,2012-2, Kanban
Frontend,46,903,33,982,02-07-2012,2012-3, Kanban
Frontend,496,490,127,1113,04-07-2012,2012-3, Kanban
Frontend,0,11,2,13,19-10-2012,2012-4, Kanban
Frontend,1,9,11,21,11-07-2012,2012-3, Kanban
Frontend,0,0,0,0,16-08-2012,2012-3, Kanban
Frontend,0,0,0,0,22-08-2012,2012-3, Kanban
Frontend,0,0,0,0,18-08-2012,2012-3, Kanban
Frontend,0,3,1,4,10-08-2012,2012-3, Kanban
Frontend,7,9,7,23,24-08-2012,2012-3, Kanban
Frontend,14,234,21,269,29-08-2012,2012-3, Kanban
Frontend,0,0,0,0,21-08-2012,2012-3, Kanban
Frontend,93,305,99,497,05-09-2012,2012-3, Kanban
Frontend,3,150,15,168,06-09-2012,2012-3, Kanban
Frontend,27,313,66,406,01-09-2012,2012-3, Kanban
Frontend,3460,5230,2271,10961,25-09-2012,2012-3, Kanban
Frontend,365,3175,660,4200,09-11-2012,2012-4, Kanban
Frontend,4,33,4,41,04-09-2012,2012-3, Kanban
Frontend,1794,3230,839,5863,08-09-2012,2012-3, Kanban
Frontend,1862,3094,852,5808,13-09-2012,2012-3, Kanban
Frontend,6,159,25,190,07-09-2012,2012-3, Kanban
Frontend,45,118,8,171,10-09-2012,2012-3, Kanban
Frontend,8,10,5,23,11-09-2012,2012-3, Kanban
Frontend,0,79,21,100,18-09-2012,2012-3, Kanban
Frontend,342,961,239,1542,14-09-2012,2012-3, Kanban
Frontend,1,1,0,2,12-09-2012,2012-3, Kanban
Frontend,0,36,0,36,06-12-2012,2012-4, Kanban
Frontend,287,279,477,1043,17-09-2012,2012-3, Kanban
Frontend,0,7,1,8,01-11-2012,2012-4, Kanban
Frontend,147,162,93,402,21-09-2012,2012-3, Kanban
Frontend,898,1032,555,2485,02-10-2012,2012-4, Kanban
Frontend,10,19,16,45,22-11-2012,2012-4, Kanban
Frontend,29,25,16,70,26-09-2012,2012-3, Kanban
Frontend,52,244,252,548,05-10-2012,2012-4, Kanban
Frontend,269,1165,232,1666,06-10-2012,2012-4, Kanban
Frontend,0,0,5,5,24-09-2012,2012-3, Kanban
Frontend,115,2628,357,3100,25-10-2012,2012-4, Kanban
Frontend,746,1207,491,2444,28-09-2012,2012-3, Kanban
Frontend,1023,1125,583,2731,04-10-2012,2012-4, Kanban
Frontend,809,784,453,2046,01-10-2012,2012-4, Kanban
Frontend,0,0,0,0,23-11-2012,2012-4, Kanban
Frontend,49,12,37,98,18-10-2012,2012-4, Kanban
Frontend,535,16,8,559,30-11-2012,2012-4, Kanban
Frontend,2848,8627,6670,18145,12-10-2012,2012-4, Kanban
Frontend,8,95,32,135,03-10-2012,2012-4, Kanban
Frontend,0,41,14,55,11-10-2012,2012-4, Kanban
Frontend,77,1867,193,2137,13-10-2012,2012-4, Kanban
Frontend,414,1785,431,2630,09-10-2012,2012-4, Kanban
Frontend,316,1079,202,1597,23-10-2012,2012-4, Kanban
Frontend,2,40,15,57,02-11-2012,2012-4, Kanban
Frontend,179,183,74,436,08-10-2012,2012-4, Kanban
Frontend,15,162,33,210,10-10-2012,2012-4, Kanban
Frontend,184,233,221,638,17-11-2012,2012-4, Kanban
Frontend,52,187,20,259,15-10-2012,2012-4, Kanban
Frontend,0,69,19,88,26-10-2012,2012-4, Kanban
Krypton,498,590,312,1400,06-09-2010,2010-3, Kanban
Krypton,0,133,4,137,06-10-2010,2010-4, Kanban
Krypton,4357,4846,3432,12635,28-09-2010,2010-3, Kanban
Krypton,21,49,24,94,10-11-2010,2010-4, Kanban
Krypton,540,1100,883,2523,16-11-2010,2010-4, Kanban
Krypton,28,180,2,210,28-10-2010,2010-4, Kanban
Krypton,0,164,1,165,29-10-2010,2010-4, Kanban
Krypton,2028,1508,944,4480,11-11-2010,2010-4, Kanban
Krypton,3616,29,31,3676,17-11-2010,2010-4, Kanban
Krypton,14959,215,215,15389,19-11-2010,2010-4, Kanban
Krypton,390,458,260,1108,12-10-2010,2010-4, Kanban
Krypton,4955,2081,609,7645,02-11-2010,2010-4, Kanban
Krypton,791,502,245,1538,24-11-2010,2010-4, Kanban
Krypton,2172,872,293,3337,12-11-2010,2010-4, Kanban
Krypton,1406,983,579,2968,30-12-2010,2010-4, Kanban
Krypton,5,92,25,122,27-09-2010,2010-3, Kanban
Krypton,3,90,14,107,09-12-2010,2010-4, Kanban
Krypton,269,674,745,1688,26-11-2010,2010-4, Kanban
Krypton,18,208,34,260,09-09-2010,2010-3, Kanban
Krypton,146,466,31,643,13-10-2010,2010-4, Kanban
Krypton,314,635,233,1182,24-09-2010,2010-3, Kanban
Krypton,788,642,102,1532,20-09-2010,2010-3, Kanban
Krypton,78,163,7,248,08-09-2010,2010-3, Kanban
Krypton,23,206,29,258,10-09-2010,2010-3, Kanban
Krypton,23,580,44,647,21-09-2010,2010-3, Kanban
Krypton,1058,856,672,2586,23-12-2010,2010-4, Kanban
Krypton,1,162,14,177,20-10-2010,2010-4, Kanban
Krypton,5,145,25,175,25-10-2010,2010-4, Kanban
Krypton,519,1667,380,2566,29-09-2010,2010-3, Kanban
Krypton,5,5,1,11,23-09-2010,2010-3, Kanban
Krypton,14,71,20,105,14-10-2010,2010-4, Kanban
Krypton,149,331,43,523,05-10-2010,2010-4, Kanban
Krypton,8,224,35,267,11-10-2010,2010-4, Kanban
Krypton,0,582,3,585,01-10-2010,2010-4, Kanban
Krypton,5,202,15,222,04-10-2010,2010-4, Kanban
Krypton,144,511,65,720,26-10-2010,2010-4, Kanban
Krypton,7035,1010,311,8356,22-10-2010,2010-4, Kanban
Krypton,0,303,3,306,15-10-2010,2010-4, Kanban
Krypton,69,249,49,367,18-10-2010,2010-4, Kanban
Krypton,7,468,29,504,19-10-2010,2010-4, Kanban
Krypton,0,0,1,1,08-10-2010,2010-4, Kanban
Krypton,3,93,55,151,03-11-2010,2010-4, Kanban
Krypton,334,429,93,856,21-10-2010,2010-4, Kanban
Krypton,222,496,373,1091,07-12-2010,2010-4, Kanban
Krypton,12,241,37,290,27-10-2010,2010-4, Kanban
Krypton,284,950,104,1338,05-11-2010,2010-4, Kanban
Krypton,1739,3059,653,5451,04-11-2010,2010-4, Kanban
Krypton,5065,546,223,5834,01-11-2010,2010-4, Kanban
Krypton,5,0,3,8,09-11-2010,2010-4, Kanban
Krypton,448,797,123,1368,08-11-2010,2010-4, Kanban
Krypton,892,796,174,1862,18-11-2010,2010-4, Kanban
Krypton,828,114,68,1010,15-11-2010,2010-4, Kanban
Krypton,1172,1543,1961,4676,04-01-2011,2011-1, Kanban
Krypton,5,159,11,175,12-12-2010,2010-4, Kanban
Krypton,241,923,408,1572,08-12-2010,2010-4, Kanban
Krypton,200,132,10,342,23-11-2010,2010-4, Kanban
Krypton,462,113,82,657,06-12-2010,2010-4, Kanban
Krypton,8531,530,85,9146,22-11-2010,2010-4, Kanban
Krypton,3413,14655,3581,21649,18-01-2011,2011-1, Kanban
Krypton,235,698,461,1394,06-01-2011,2011-1, Kanban
Krypton,113,191,104,408,30-01-2011,2011-1, Kanban
Krypton,28,343,13,384,03-12-2010,2010-4, Kanban
Krypton,1025,2412,1280,4717,16-12-2010,2010-4, Kanban
Krypton,939,813,423,2175,10-12-2010,2010-4, Kanban
Krypton,1449,1503,1170,4122,13-12-2010,2010-4, Kanban
Krypton,1137,1033,327,2497,07-03-2011,2011-1, Kanban
Krypton,544,395,381,1320,15-12-2010,2010-4, Kanban
Krypton,3,0,2,5,11-12-2010,2010-4, Kanban
Krypton,606,655,502,1763,13-01-2011,2011-1, Kanban
Krypton,573,1221,417,2211,23-11-2011,2011-4, Kanban
Krypton,0,4,3,7,21-12-2010,2010-4, Kanban
Krypton,0,37,1,38,03-01-2011,2011-1, Kanban
Krypton,48,64,18,130,12-01-2011,2011-1, Kanban
Krypton,0,3,0,3,10-01-2011,2011-1, Kanban
Krypton,0,22,3,25,11-01-2011,2011-1, Kanban
Krypton,588,1008,418,2014,17-01-2011,2011-1, Kanban
Krypton,0,0,1,1,14-01-2011,2011-1, Kanban
Krypton,588,1799,289,2676,25-01-2011,2011-1, Kanban
Krypton,0,0,0,0,26-01-2011,2011-1, Kanban
Krypton,12,158,67,237,28-03-2011,2011-1, Kanban
Krypton,35,369,120,524,03-03-2011,2011-1, Kanban
Krypton,5,7,6,18,11-04-2011,2011-2, Kanban
Krypton,0,0,0,0,24-01-2011,2011-1, Kanban
Krypton,13,99,83,195,20-01-2011,2011-1, Kanban
Krypton,113,134,141,388,19-01-2011,2011-1, Kanban
Krypton,60,224,50,334,17-02-2011,2011-1, Kanban
Krypton,16,172,377,565,21-01-2011,2011-1, Kanban
Krypton,510,1646,267,2423,04-03-2011,2011-1, Kanban
Krypton,459,529,433,1421,10-02-2011,2011-1, Kanban
Krypton,33,88,34,155,31-01-2011,2011-1, Kanban
Krypton,1,0,8,9,28-01-2011,2011-1, Kanban
Krypton,13,35,5,53,01-02-2011,2011-1, Kanban
Krypton,5,288,6,299,02-02-2011,2011-1, Kanban
Krypton,2,2,1,5,03-02-2011,2011-1, Kanban
Krypton,200,1885,304,2389,15-02-2011,2011-1, Kanban
Krypton,328,282,108,718,04-02-2011,2011-1, Kanban
Krypton,10,182,68,260,07-02-2011,2011-1, Kanban
Krypton,25,30,62,117,08-02-2011,2011-1, Kanban
Krypton,308,234,69,611,09-02-2011,2011-1, Kanban
Krypton,1,2,0,3,11-02-2011,2011-1, Kanban
Krypton,0,788,33,821,14-02-2011,2011-1, Kanban
Krypton,91,180,45,316,16-02-2011,2011-1, Kanban
Krypton,99,199,64,362,23-02-2011,2011-1, Kanban
Krypton,0,0,2,2,21-02-2011,2011-1, Kanban
Krypton,82,106,101,289,22-02-2011,2011-1, Kanban
Krypton,35,116,39,190,01-03-2011,2011-1, Kanban
Krypton,0,3,2,5,24-02-2011,2011-1, Kanban
Krypton,6,15,0,21,25-02-2011,2011-1, Kanban
Krypton,15,112,29,156,02-03-2011,2011-1, Kanban
Krypton,553,173,325,1051,08-03-2011,2011-1, Kanban
Krypton,10,7,16,33,16-03-2011,2011-1, Kanban
Krypton,105,314,60,479,09-03-2011,2011-1, Kanban
Krypton,3,0,11,14,11-03-2011,2011-1, Kanban
Krypton,266,95,19,380,15-03-2011,2011-1, Kanban
Krypton,143,267,326,736,17-03-2011,2011-1, Kanban
Krypton,0,0,2,2,22-03-2011,2011-1, Kanban
Krypton,885,1188,1141,3214,31-03-2011,2011-1, Kanban
Krypton,29,127,74,230,30-03-2011,2011-1, Kanban
Krypton,13,39,2,54,23-03-2011,2011-1, Kanban
Krypton,132,549,129,810,12-05-2011,2011-2, Kanban
Krypton,917,1826,1178,3921,27-04-2011,2011-2, Kanban
Krypton,9,109,24,142,29-03-2011,2011-1, Kanban
Krypton,22,121,31,174,04-04-2011,2011-2, Kanban
Krypton,7949,5990,2110,16049,15-07-2011,2011-3, Kanban
Krypton,130,634,168,932,07-04-2011,2011-2, Kanban
Krypton,54,292,74,420,22-06-2011,2011-2, Kanban
Krypton,0,52,7,59,05-04-2011,2011-2, Kanban
Krypton,10,129,13,152,13-04-2011,2011-2, Kanban
Krypton,43,41,2,86,08-04-2011,2011-2, Kanban
Krypton,0,5,6,11,10-05-2011,2011-2, Kanban
Krypton,0,2,4,6,13-05-2011,2011-2, Kanban
Krypton,0,7,3,10,09-05-2011,2011-2, Kanban
Krypton,1239,1590,1289,4118,18-05-2011,2011-2, Kanban
Krypton,0,0,0,0,26-05-2011,2011-2, Kanban
Krypton,137,467,115,719,20-05-2011,2011-2, Kanban
Krypton,5,0,1,6,16-05-2011,2011-2, Kanban
Krypton,4,20,8,32,23-05-2011,2011-2, Kanban
Krypton,1312,2982,1321,5615,15-06-2011,2011-2, Kanban
Krypton,0,29,0,29,24-05-2011,2011-2, Kanban
Krypton,1521,810,583,2914,14-06-2011,2011-2, Kanban
Krypton,14,69,8,91,25-05-2011,2011-2, Kanban
Krypton,0,0,0,0,27-05-2011,2011-2, Kanban
Krypton,81,118,118,317,30-05-2011,2011-2, Kanban
Krypton,66,46,13,125,07-06-2011,2011-2, Kanban
Krypton,115,131,127,373,08-06-2011,2011-2, Kanban
Krypton,400,265,232,897,28-06-2011,2011-2, Kanban
Krypton,29,41,15,85,09-06-2011,2011-2, Kanban
Krypton,8,8,2,18,10-06-2011,2011-2, Kanban
Krypton,2,35,5,42,17-06-2011,2011-2, Kanban
Krypton,0,22,4,26,16-06-2011,2011-2, Kanban
Krypton,0,0,0,0,21-06-2011,2011-2, Kanban
Krypton,47,240,105,392,23-08-2011,2011-3, Kanban
Krypton,61,103,22,186,07-07-2011,2011-3, Kanban
Krypton,1,139,19,159,06-09-2012,2012-3, Kanban
Krypton,0,25,12,37,17-08-2011,2011-3, Kanban
Krypton,0,112,5,117,30-06-2011,2011-2, Kanban
Krypton,0,110,0,110,11-07-2011,2011-3, Kanban
Krypton,1,41,5,47,24-06-2011,2011-2, Kanban
Krypton,316,93,121,530,12-08-2011,2011-3, Kanban
Krypton,0,16,0,16,13-07-2011,2011-3, Kanban
Krypton,0,8,0,8,01-07-2011,2011-3, Kanban
Krypton,0,0,1,1,08-09-2011,2011-3, Kanban
Krypton,5,0,0,5,06-07-2011,2011-3, Kanban
Krypton,5,0,0,5,12-07-2011,2011-3, Kanban
Krypton,0,11,1,12,29-09-2011,2011-3, Kanban
Krypton,8,173,16,197,19-08-2011,2011-3, Kanban
Krypton,3,177,10,190,22-08-2011,2011-3, Kanban
Krypton,0,0,0,0,20-07-2011,2011-3, Kanban
Krypton,1116,3405,1696,6217,22-07-2011,2011-3, Kanban
Krypton,0,0,0,0,25-07-2011,2011-3, Kanban
Krypton,827,868,321,2016,19-07-2011,2011-3, Kanban
Krypton,0,11,1,12,30-09-2011,2011-3, Kanban
Krypton,597,838,543,1978,15-08-2011,2011-3, Kanban
Krypton,247,481,213,941,14-10-2011,2011-4, Kanban
Krypton,40,12,69,121,29-08-2011,2011-3, Kanban
Krypton,55,136,25,216,06-09-2011,2011-3, Kanban
Krypton,85,119,50,254,19-09-2011,2011-3, Kanban
Krypton,2,308,17,327,24-08-2011,2011-3, Kanban
Krypton,80,125,21,226,12-09-2011,2011-3, Kanban
Krypton,27,55,9,91,16-09-2011,2011-3, Kanban
Krypton,0,22,1,23,07-10-2011,2011-4, Kanban
Krypton,0,11,2,13,26-08-2011,2011-3, Kanban
Krypton,15,72,28,115,30-08-2011,2011-3, Kanban
Krypton,2,106,17,125,01-09-2011,2011-3, Kanban
Krypton,409,1560,334,2303,11-04-2012,2012-2, Kanban
Krypton,390,402,198,990,03-10-2011,2011-4, Kanban
Krypton,218,218,129,565,21-09-2011,2011-3, Kanban
Krypton,220,223,151,594,23-09-2011,2011-3, Kanban
Krypton,342,491,293,1126,22-09-2011,2011-3, Kanban
Krypton,41,66,40,147,07-09-2011,2011-3, Kanban
Krypton,496,588,557,1641,06-10-2011,2011-4, Kanban
Krypton,0,24,9,33,26-09-2011,2011-3, Kanban
Krypton,57,149,30,236,31-10-2011,2011-4, Kanban
Krypton,1123,301,174,1598,20-09-2011,2011-3, Kanban
Krypton,0,14,3,17,28-09-2011,2011-3, Kanban
Krypton,312,464,379,1155,17-10-2011,2011-4, Kanban
Krypton,0,0,0,0,04-10-2011,2011-4, Kanban
Krypton,0,20,4,24,11-10-2011,2011-4, Kanban
Krypton,0,1,56,57,10-10-2011,2011-4, Kanban
Krypton,0,43,12,55,05-11-2011,2011-4, Kanban
Krypton,18,628,65,711,24-10-2011,2011-4, Kanban
Krypton,148,216,80,444,12-10-2011,2011-4, Kanban
Krypton,0,0,0,0,15-10-2011,2011-4, Kanban
Krypton,1,106,0,107,16-10-2011,2011-4, Kanban
Krypton,8,45,15,68,02-11-2011,2011-4, Kanban
Krypton,17,81,126,224,20-10-2011,2011-4, Kanban
Krypton,0,0,0,0,19-10-2011,2011-4, Kanban
Krypton,0,52,19,71,21-10-2011,2011-4, Kanban
Krypton,0,0,0,0,06-11-2011,2011-4, Kanban
Krypton,211,387,199,797,14-11-2011,2011-4, Kanban
Krypton,46,175,62,283,16-11-2011,2011-4, Kanban
Krypton,1076,1116,876,3068,15-11-2011,2011-4, Kanban
Krypton,217,387,55,659,10-03-2012,2012-1, Kanban
Krypton,0,58,18,76,10-11-2011,2011-4, Kanban
Krypton,0,13,5,18,11-11-2011,2011-4, Kanban
Krypton,273,586,213,1072,11-12-2011,2011-4, Kanban
Krypton,58,349,95,502,09-12-2011,2011-4, Kanban
Krypton,0,184,166,350,21-12-2011,2011-4, Kanban
Krypton,303,1125,851,2279,13-12-2011,2011-4, Kanban
Krypton,524,594,256,1374,18-11-2011,2011-4, Kanban
Krypton,0,0,0,0,22-11-2011,2011-4, Kanban
Krypton,628,783,362,1773,16-01-2012,2012-1, Kanban
Krypton,62,111,44,217,01-12-2011,2011-4, Kanban
Krypton,267,1630,448,2345,09-01-2012,2012-1, Kanban
Krypton,64,235,98,397,02-01-2012,2012-1, Kanban
Krypton,281,792,374,1447,29-11-2011,2011-4, Kanban
Krypton,101,495,94,690,02-12-2011,2011-4, Kanban
Krypton,0,8,8,16,28-11-2011,2011-4, Kanban
Krypton,0,0,2,2,05-12-2011,2011-4, Kanban
Krypton,120,130,24,274,06-12-2011,2011-4, Kanban
Krypton,4,104,6,114,04-01-2012,2012-1, Kanban
Krypton,12,18,3,33,07-12-2011,2011-4, Kanban
Krypton,0,0,0,0,06-01-2012,2012-1, Kanban
Krypton,0,22,4,26,12-12-2011,2011-4, Kanban
Krypton,39,65,31,135,14-12-2011,2011-4, Kanban
Krypton,110,283,74,467,16-12-2011,2011-4, Kanban
Krypton,10,5,2,17,20-12-2011,2011-4, Kanban
Krypton,3,0,11,14,23-12-2011,2011-4, Kanban
Krypton,9,2,24,35,11-01-2012,2012-1, Kanban
Krypton,0,30,0,30,27-12-2011,2011-4, Kanban
Krypton,0,21,0,21,03-01-2012,2012-1, Kanban
Krypton,26,45,11,82,05-01-2012,2012-1, Kanban
Krypton,799,3223,157,4179,20-03-2012,2012-1, Kanban
Krypton,174,941,222,1337,21-03-2012,2012-1, Kanban
Krypton,1,76,3,80,17-01-2012,2012-1, Kanban
Krypton,87,168,112,367,18-01-2012,2012-1, Kanban
Krypton,10,52,17,79,26-01-2012,2012-1, Kanban
Krypton,0,0,2,2,30-01-2012,2012-1, Kanban
Krypton,305,104,79,488,08-03-2012,2012-1, Kanban
Krypton,92,94,110,296,03-02-2012,2012-1, Kanban
Krypton,0,0,0,0,27-03-2012,2012-1, Kanban
Krypton,0,12,16,28,08-02-2012,2012-1, Kanban
Krypton,0,0,0,0,24-02-2012,2012-1, Kanban
Krypton,1,33,3,37,14-02-2012,2012-1, Kanban
Krypton,590,466,214,1270,20-09-2012,2012-3, Kanban
Krypton,5,0,1,6,16-02-2012,2012-1, Kanban
Krypton,0,0,2,2,01-03-2012,2012-1, Kanban
Krypton,82,66,17,165,17-02-2012,2012-1, Kanban
Krypton,2039,2227,1609,5875,27-02-2012,2012-1, Kanban
Krypton,0,5,8,13,20-02-2012,2012-1, Kanban
Krypton,0,35,104,139,21-02-2012,2012-1, Kanban
Krypton,2,58,21,81,28-02-2012,2012-1, Kanban
Krypton,0,354,20,374,09-03-2012,2012-1, Kanban
Krypton,0,0,6,6,03-03-2012,2012-1, Kanban
Krypton,333,596,151,1080,06-03-2012,2012-1, Kanban
Krypton,0,0,0,0,24-03-2012,2012-1, Kanban
Krypton,5,2,10,17,15-03-2012,2012-1, Kanban
Krypton,0,0,0,0,13-03-2012,2012-1, Kanban
Krypton,0,119,40,159,19-03-2012,2012-1, Kanban
Krypton,5,95,430,530,30-03-2012,2012-1, Kanban
Krypton,0,0,0,0,09-06-2012,2012-2, Kanban
Krypton,0,47,15,62,28-03-2012,2012-1, Kanban
Krypton,0,21,3,24,19-04-2012,2012-2, Kanban
Krypton,39,272,111,422,20-04-2012,2012-2, Kanban
Krypton,0,0,1,1,24-04-2012,2012-2, Kanban
Krypton,0,0,0,0,11-05-2012,2012-2, Kanban
Krypton,858,5904,2151,8913,25-04-2012,2012-2, Kanban
Krypton,302,598,379,1279,08-06-2012,2012-2, Kanban
Krypton,0,0,3,3,12-05-2012,2012-2, Kanban
Krypton,173,462,142,777,02-06-2012,2012-2, Kanban
Krypton,24,100,65,189,23-05-2012,2012-2, Kanban
Krypton,16,32,28,76,30-05-2012,2012-2, Kanban
Krypton,0,0,25,25,31-05-2012,2012-2, Kanban
Krypton,46,62,58,166,06-06-2012,2012-2, Kanban
Krypton,143,242,70,455,16-06-2012,2012-2, Kanban
Krypton,6,108,22,136,14-06-2012,2012-2, Kanban
Krypton,0,0,0,0,11-06-2012,2012-2, Kanban
Krypton,1734,370,136,2240,14-08-2012,2012-3, Kanban
Krypton,7,63,7,77,12-06-2012,2012-2, Kanban
Krypton,113,441,215,769,13-06-2012,2012-2, Kanban
Krypton,2,41,1,44,27-06-2012,2012-2, Kanban
Krypton,140,244,62,446,26-07-2012,2012-3, Kanban
Krypton,0,21,0,21,15-06-2012,2012-2, Kanban
Krypton,175,103,29,307,18-06-2012,2012-2, Kanban
Krypton,33,52,25,110,19-06-2012,2012-2, Kanban
Krypton,1,18,4,23,23-06-2012,2012-2, Kanban
Krypton,1,18,4,23,20-06-2012,2012-2, Kanban
Krypton,264,474,266,1004,25-06-2012,2012-2, Kanban
Krypton,2,19,0,21,26-06-2012,2012-2, Kanban
Krypton,7,26,18,51,28-06-2012,2012-2, Kanban
Krypton,63,143,227,433,03-07-2012,2012-3, Kanban
Krypton,164,392,351,907,05-07-2012,2012-3, Kanban
Krypton,21,51,72,144,04-07-2012,2012-3, Kanban
Krypton,0,4,10,14,07-07-2012,2012-3, Kanban
Krypton,86,153,131,370,09-07-2012,2012-3, Kanban
Krypton,2,71,7,80,16-08-2012,2012-3, Kanban
Krypton,5,29,4,38,10-07-2012,2012-3, Kanban
Krypton,0,310,8,318,12-07-2012,2012-3, Kanban
Krypton,0,100,12,112,13-07-2012,2012-3, Kanban
Krypton,9,107,27,143,13-09-2012,2012-3, Kanban
Krypton,3,73,27,103,17-08-2012,2012-3, Kanban
Krypton,770,1148,304,2222,05-09-2012,2012-3, Kanban
Krypton,86,22,16,124,18-08-2012,2012-3, Kanban
Krypton,28,21,10,59,23-08-2012,2012-3, Kanban
Krypton,12520,1524,798,14842,15-08-2012,2012-3, Kanban
Krypton,39,131,84,254,20-08-2012,2012-3, Kanban
Krypton,132,201,113,446,21-08-2012,2012-3, Kanban
Krypton,43,139,72,254,24-08-2012,2012-3, Kanban
Krypton,928,2456,1229,4613,27-08-2012,2012-3, Kanban
Krypton,29,85,64,178,25-08-2012,2012-3, Kanban
Krypton,58,44,8,110,28-08-2012,2012-3, Kanban
Krypton,112,551,176,839,12-09-2012,2012-3, Kanban
Krypton,164,100,24601,24865,29-08-2012,2012-3, Kanban
Krypton,38,76,10,124,30-08-2012,2012-3, Kanban
Krypton,0,0,8,8,03-09-2012,2012-3, Kanban
Krypton,9,198,41,248,10-09-2012,2012-3, Kanban
Krypton,10,85,26,121,08-09-2012,2012-3, Kanban
Krypton,0,13,4,17,07-09-2012,2012-3, Kanban
Krypton,132,158,7,297,11-09-2012,2012-3, Kanban
Krypton,31,142,53,226,18-09-2012,2012-3, Kanban
Krypton,3343,96,95,3534,24-09-2012,2012-3, Kanban
Krypton,9,377,10,396,21-09-2012,2012-3, Kanban
Krypton,15,347,62,424,22-09-2012,2012-3, Kanban
Krypton,0,40,3,43,01-10-2012,2012-4, Kanban
Krypton,1576,1047,1997,4620,02-10-2012,2012-4, Kanban
Krypton,19,9,17,45,06-12-2012,2012-4, Kanban
